0,0,0,0,0,0,0,0,0,0,0,0,0,0,0,0,0,0,0,0
0,0,0,0,0,0,0,0,0,0,0,0,0,0,0,0,0,0,0,0
0,0,0,0,0,0,0,0,0,0,0,0,0,0,0,0,0,0,0,0
0,0,0,0,0,0,0,0,0,0,0,0,0,0,0,0,0,0,0,0
0,0,0,0,0,3,3,3,3,3,3,3,3,3,3,0,0,0,0,0
0,0,0,0,0,3,0,0,0,0,0,0,0,0,3,0,0,0,0,0
0,0,0,0,0,3,0,0,0,0,0,0,0,0,3,0,0,0,0,0
0,0,0,0,0,3,0,0,0,0,0,0,0,0,3,0,0,0,0,0
0,0,0,0,0,0,0,0,0,0,0,0,0,0,3,0,0,0,0,0
0,0,0,0,0,0,0,0,0,2,0,0,0,0,3,0,0,0,0,0
0,0,0,0,0,3,0,0,0,0,0,0,0,0,3,0,0,0,0,0
0,0,0,0,0,3,0,0,0,0,0,0,0,0,3,0,0,0,0,0
0,0,0,0,0,3,0,0,0,0,0,0,0,0,3,0,0,0,0,0
0,0,0,0,0,3,0,0,0,0,0,0,0,0,3,0,0,0,0,0
0,0,0,0,0,3,0,0,0,0,0,0,0,0,3,0,0,0,0,0
0,0,0,0,0,3,0,0,0,0,0,0,0,0,3,0,0,0,0,0
0,0,0,0,0,3,3,3,3,3,3,3,3,3,3,0,0,0,0,0
0,0,0,0,0,0,0,0,0,0,0,0,0,0,0,0,0,0,0,0
0,0,0,0,0,0,0,0,0,0,0,0,0,0,0,0,0,0,0,0
0,0,0,0,0,0,0,0,0,0,0,0,0,0,0,0,0,0,0,0
9,9,9,9


0,0,0,0,0,0,0,4,2,0,0,0,0,0,0,0,0,0,0,0
0,3,0,4,0,0,0,0,0,0,0,0,0,0,0,0,0,0,0,0
0,0,0,0,0,0,0,0,4,4,4,0,0,0,0,0,0,0,0,0
0,0,0,0,0,0,0,0,4,0,4,0,0,0,0,0,0,0,0,0
0,0,0,0,0,3,3,3,3,0,4,3,3,3,3,0,0,0,0,0
0,0,0,0,0,3,0,0,0,0,0,0,0,0,3,0,0,0,0,0
0,0,3,0,0,3,0,0,0,0,0,0,0,0,3,0,0,0,0,0
0,0,0,0,0,3,0,0,0,0,0,0,0,0,3,0,0,0,0,0
3,3,0,0,0,0,0,4,4,4,3,4,0,4,4,3,3,0,0,0
0,0,0,0,0,3,0,0,0,0,0,0,0,0,3,0,0,0,0,0
0,0,0,0,0,3,0,0,0,0,0,0,0,0,3,0,0,0,0,0
0,0,0,0,0,3,0,0,0,0,0,0,0,0,3,0,0,0,0,0
0,0,0,0,0,3,0,0,0,0,0,0,0,0,3,0,0,0,0,0
0,0,0,0,0,3,0,0,0,0,3,0,0,0,0,0,0,0,0,0
0,0,0,0,0,3,0,0,0,0,0,0,0,0,3,0,0,0,0,0
0,0,3,0,0,3,0,0,0,0,0,0,0,0,3,0,0,0,0,0
4,0,0,0,3,3,0,3,3,3,3,3,3,3,3,0,0,0,0,0
0,0,4,0,0,0,0,0,0,0,0,0,0,0,3,4,0,0,0,0
0,0,0,0,0,0,4,4,4,0,0,3,0,0,0,0,0,0,0,0
0,0,4,0,0,0,0,4,3,3,0,0,0,0,0,0,0,0,0,0
0,8,0,8


0,0,0,0,0,3,0,0,0,0,0,0,0,0,3,0,0,0,0,0
0,0,0,0,0,3,0,0,0,0,0,0,0,0,3,0,0,0,0,0
0,0,0,0,0,3,0,0,0,0,3,0,0,0,0,0,0,0,0,0
0,0,0,0,0,3,0,0,0,0,0,0,0,0,3,0,0,0,0,0
0,0,3,0,0,3,0,0,0,0,0,0,0,0,3,0,0,0,0,0
4,0,0,0,3,3,0,3,3,3,3,3,3,3,3,0,0,0,0,0
0,0,4,0,0,0,0,0,0,0,0,0,0,0,3,4,0,0,0,0
0,0,0,0,0,0,4,4,4,0,0,3,0,0,0,0,0,0,0,0
0,0,4,0,0,0,0,4,3,3,0,0,0,0,0,0,0,0,0,0
0,0,0,0,0,0,0,4,2,0,0,0,0,0,0,0,0,0,0,0
0,3,0,4,0,0,0,0,0,0,0,0,0,0,0,0,0,0,0,0
0,0,0,0,0,0,0,0,4,4,4,0,0,0,0,0,0,0,0,0
0,0,0,0,0,0,0,0,4,0,4,0,0,0,0,0,0,0,0,0
0,0,0,0,0,3,3,3,3,0,4,3,3,3,3,0,0,0,0,0
0,0,0,0,0,3,0,0,0,0,0,0,0,0,3,0,0,0,0,0
0,0,3,0,0,3,0,0,0,0,0,0,0,0,3,0,0,0,0,0
0,0,0,0,0,3,0,0,0,0,0,0,0,0,3,0,0,0,0,0
3,3,0,0,0,0,0,4,4,4,3,4,0,4,4,3,3,0,0,0
0,0,0,0,0,3,0,0,0,0,0,0,0,0,3,0,0,0,0,0
0,0,0,0,0,3,0,0,0,0,0,0,0,0,3,0,0,0,0,0
9,8,9,8

0,0,3,0,0,3,0,0,0,0,0,0,0,0,3,0,0,0,0,0
0,0,0,0,0,3,0,0,0,0,0,0,0,0,3,0,0,0,0,0
0,0,0,0,0,3,0,0,0,0,0,0,0,0,3,0,0,0,0,0
0,0,0,0,0,3,0,0,0,0,3,0,0,0,0,0,0,0,0,0
0,0,0,0,0,3,0,0,0,0,0,0,0,0,3,0,0,0,0,0
4,0,0,0,3,3,0,3,3,3,3,3,3,3,3,0,0,0,0,0
0,0,4,0,0,0,0,0,0,0,0,0,0,0,3,4,0,0,0,0
0,0,0,0,0,0,4,4,4,0,0,3,0,0,0,0,0,0,0,0
0,0,0,0,0,0,0,0,4,4,4,0,0,0,0,0,0,0,0,0
0,0,0,0,0,0,0,0,4,0,4,0,0,0,0,0,0,0,0,0
0,0,4,0,0,0,0,4,3,3,0,0,0,0,0,0,0,0,0,0
0,0,0,0,0,0,0,4,2,0,0,0,0,0,0,0,0,0,0,0
0,3,0,4,0,0,0,0,0,0,0,0,0,0,0,0,0,0,0,0
0,0,3,0,0,3,0,0,0,0,0,0,0,0,3,0,0,0,0,0
0,0,0,0,0,3,0,0,0,0,0,0,0,0,3,0,0,0,0,0
3,3,0,0,0,0,0,4,4,4,3,4,0,4,4,3,3,0,0,0
0,0,0,0,0,3,0,0,0,0,0,0,0,0,3,0,0,0,0,0
0,0,0,0,0,3,3,3,3,0,4,3,3,3,3,0,0,0,0,0
0,0,0,0,0,3,0,0,0,0,0,0,0,0,3,0,0,0,0,0
0,0,0,0,0,3,0,0,0,0,0,0,0,0,3,0,0,0,0,0
11,8,11,8